1111111
1P0C001
1000001
100E000
1111111