1111111111111111111111111111111
1P000000000C0000C000000000000E1
1000000000000000000000000000001
1000000000C00000000000000000001
1000000000000000000000000000001
1000000C00000000000000C00000001
1000000000000000000000000000001
1111111111111111111111111111111