1111111
1P0C001
1000001
100E001
1111111