11111111111111111
1P000C00000C000E1
10X0000X00000X001
1000C00000C000001
1X000000000000X01
11111111111111111