1111111
1P0C001
10X0V01
100E001
1111111