1111111
1P1C001
1111011
100E001
1111111