1111111
1P1C001
1111X11
100E001
1111111