1111111
1P0CP01
1000001
100E001
1111111