1111111
1PXC0E1
100C001
100C001
1111111