1111111111111
1C00X00000001
1000000000001
1P00000X000E1
1111111111111